fff9dc19dc19dc19dc19dc19dc19dc19fff9fff9fff9fff9fff9fff9fff9fff9fff9fff9fff9fff9fff9fff9fff9fff9fff9fff9fff9fff9fff9fff9fff9fff9fff9fff9fff9fff9fff9dc19dc19dc19dc19fff9fff9fff9fff9fff9fff9fff9fff9fff9fff9fff9fff9fff9fff9fff9fff9fff9fff9fff9fff9fff9fff9fff9fff9fff9fff9fff9fff9fff9fff9dc19dc19dc19dc19dc19dc19dc19fff9
fff9fff1fff1fff1fff1fff1fff1fff1fff9fff9fff9fff9fff9fff9fff9fff9fff9fff9fff9fff9fff9fff9fff9fff9fff9fff9fff9fff9fff9fff9fff9fff9fff9fff9fff9fff9fff9fff1fff1fff1fff1fff9fff9fff9fff9fff9fff9fff9fff9fff9fff9fff9fff9fff9fff9fff9fff9fff9fff9fff9fff9fff9fff9fff9fff9fff9fff9fff9fff9fff9fff9fff1fff1fff1fff1fff1fff1fff1fff9
fff9dc91dc91dc91dc91dc91dc91dc91fff9fff9fff9fff9fff9fff9fff9fff9fff9fff9fff9fff9fff9fff9fff9fff9fff9fff9fff9fff9fff9fff9fff9fff9fff9fff9fff9fff9fff9dc91dc91dc91dc91fff9fff9fff9fff9fff9fff9fff9fff9fff9fff9fff9fff9fff9fff9fff9fff9fff9fff9fff9fff9fff9fff9fff9fff9fff9fff9fff9fff9fff9fff9dc91dc91dc91dc91dc91dc91dc91fff9
fff9fff9fff9fff9fff9fff9fff9fff9fff9fff9fff9fff9fff9fff9fff9fff9fff9fff9fff9fff9fff9fff9fff9fff9fff9fff9fff9fff9fff9fff9fff9fff9fff9fff9fff9fff9fff9fff9fff9fff9fff9fff9fff9fff9fff9fff9fff9fff9fff9fff9fff9fff9fff9fff9fff9fff9fff9fff9fff9fff9fff9fff9fff9fff9fff9fff9fff9fff9fff9fff9fff9fff9fff9fff9fff9fff9fff9fff9fff9
fff9fff9fff9fff9fff9fff9fff9fff9fff9fff9fff9fff9fff9fff9fff9fff9fff9fff9fff9fff9fff9fff9fff9fff9fff9fff9fff9fff9fff9fff9fff9fff9fff9fff9fff9fff9fff9fff9fff9fff9fff9fff9fff9fff9fff9fff9fff9fff9fff9fff9fff9fff9fff9fff9fff9fff9fff9fff9fff9fff9fff9fff9fff9fff9fff9fff9fff9fff9fff9fff9fff9fff9fff9fff9fff9fff9fff9fff9fff9
fff9fff9fff9fff9fff9fff9fff9fff9fff9fff9fff9fff9fff9fff9fff9fff9fff9fff9fff9fff9fff9fff9fff9fff9fff9fff9fff9fff9fff9fff9fff9fff9fff9fff9fff9fff9fff9fff9fff9fff9fff9fff9fff9fff9fff9fff9fff9fff9fff9fff9fff9fff9fff9fff9fff9fff9fff9fff9fff9fff9fff9fff9fff9fff9fff9fff9fff9fff9fff9fff9fff9fff9fff9fff9fff9fff9fff9fff9fff9
fff9fff9fff9fff9fff9fff9fff9fff9fff9fff9fff9fff9fff9fff9fff9fff9fff9fff9fff9fff9fff9fff9fff9fff9fff9fff9fff9fff9fff9fff9fff9fff9fff9fff9fff9fff9fff9fff9fff9fff9fff9fff9fff9fff9fff9fff9fff9fff9fff9fff9fff9fff9fff9fff9fff9fff9fff9fff9fff9fff9fff9fff9fff9fff9fff9fff9fff9fff9fff9fff9fff9fff9fff9fff9fff9fff9fff9fff9fff9
fff9fff9fff9fff9fff9fff9fff9fff9fff9fff9fff9fff9fff9fff9fff9fff9fff9fff9fff9fff9fff9fff9fff9fff9fff9fff9fff9fff9fff9fff9fff9fff9fff9fff9fff9fff9fff9fff9fff9fff9fff9fff9fff9fff9fff9fff9fff9fff9fff9fff9fff9fff9fff9fff9fff9fff9fff9fff9fff9fff9fff9fff9fff9fff9fff9fff9fff9fff9fff9fff9fff9fff9fff9fff9fff9fff9fff9fff9fff9
fff9fff9fff9fff9fff9fff9fff9fff9fff9fff9fff9fff9fff9fff9fff9fff9fff9fff9fff9fff9fff9fff9fff9fff9fff9fff9fff9fff9fff9fff9fff9fff9fff9fff9fff9fff9fff9fff9fff9fff9fff9fff9fff9fff9fff9fff9fff9fff9fff9fff9fff9fff9fff9fff9fff9fff9fff9fff9fff9fff9fff9fff9fff9fff9fff9fff9fff9fff9fff9fff9fff9fff9fff9fff9fff9fff9fff9fff9fff9
fff9fff9fff9fff9fff9fff9fff9fff9fff9fff9fff9fff9fff9fff9fff9fff9fff9fff9fff9fff9fff9fff9fff9fff9fff9fff9fff9fff9fff9fff9fff9fff9fff9fff9fff9fff9fff9fff9fff9fff9fff9fff9fff9fff9fff9fff9fff9fff9fff9fff9fff9fff9fff9fff9fff9fff9fff9fff9fff9fff9fff9fff9fff9fff9fff9fff9fff9fff9fff9fff9fff9fff9fff9fff9fff9fff9fff9fff9fff9
fff9fff9fff9fff9fff9fff9fff9fff9fff9fff9fff9fff9fff9fff9fff9fff9fff9fff9fff9fff9fff9fff9fff9fff9fff9fff9fff9fff9fff9fff9fff9fff9fff9fff9fff9fff9fff9fff9fff9fff9fff9fff9fff9fff9fff9fff9fff9fff9fff9fff9fff9fff9fff9fff9fff9fff9fff9fff9fff9fff9fff9fff9fff9fff9fff9fff9fff9fff9fff9fff9fff9fff9fff9fff9fff9fff9fff9fff9fff9
fff9fff9fff9fff9fff9fff9fff9fff9fff9fff9fff9fff9fff9fff9fff9fff9fff9fff9fff9fff9fff9fff9fff9fff9fff9fff9fff9fff9fff9fff9fff9fff9fff9fff9fff9fff9fff9fff9fff9fff9fff9fff9fff9fff9fff9fff9fff9fff9fff9fff9fff9fff9fff9fff9fff9fff9fff9fff9fff9fff9fff9fff9fff9fff9fff9fff9fff9fff9fff9fff9fff9fff9fff9fff9fff9fff9fff9fff9fff9
fff9fff9fff9fff9fff9fff9fff9fff9fff9fff9fff9fff9fff9fff9fff9fff9fff9fff9fff9fff9fff9fff9fff9fff9fff9fff9fff9fff9fff9fff9fff9fff9fff9fff9fff9fff9fff9fff9fff9fff9fff9fff9fff9fff9fff9fff9fff9fff9fff9fff9fff9fff9fff9fff9fff9fff9fff9fff9fff9fff9fff9fff9fff9fff9fff9fff9fff9fff9fff9fff9fff9fff9fff9fff9fff9fff9fff9fff9fff9
fff9fff9fff9fff9fff9fff9fff9fff9fff9fff9fff9fff9fff9fff9fff9fff9fff9fff9fff9fff9fff9fff9fff9fff9fff9fff9fff9fff9fff9fff9fff9fff9fff9fff9fff9fff9fff9fff9fff9fff9fff9fff9fff9fff9fff9fff9fff9fff9fff9fff9fff9fff9fff9fff9fff9fff9fff9fff9fff9fff9fff9fff9fff9fff9fff9fff9fff9fff9fff9fff9fff9fff9fff9fff9fff9fff9fff9fff9fff9
fff9fff9fff9fff9fff9fff9fff9fff9fff9fff9fff9fff9fff9fff9fff9fff9fff9fff9fff9fff9fff9fff9fff9fff9fff9fff9fff9fff9fff9fff9fff9fff9fff9fff9fff9fff9fff9fff9fff9fff9fff9fff9fff9fff9fff9fff9fff9fff9fff9fff9fff9fff9fff9fff9fff9fff9fff9fff9fff9fff9fff9fff9fff9fff9fff9fff9fff9fff9fff9fff9fff9fff9fff9fff9fff9fff9fff9fff9fff9
fff9fff9fff9fff9fff9fff9fff9fff9fff9fff9fff9fff9fff9fff9fff9fff9fff9fff9fff9fff9fff9fff9fff9fff9fff9fff9fff9fff9fff9fff9fff9fff9fff9fff9fff9fff9fff9fff9fff9fff9fff9fff9fff9fff9fff9fff9fff9fff9fff9fff9fff9fff9fff9fff9fff9fff9fff9fff9fff9fff9fff9fff9fff9fff9fff9fff9fff9fff9fff9fff9fff9fff9fff9fff9fff9fff9fff9fff9fff9
fff9fff9fff9fff9fff9fff9fff9fff9fff9fff9fff9fff9fff9fff9fff9fff9fff9fff9fff9fff9fff9fff9fff9fff9fff9fff9fff9fff9fff9fff9fff9fff9fff9fff9fff9fff9fff9fff9fff9fff9fff9fff9fff9fff9fff9fff9fff9fff9fff9fff9fff9fff9fff9fff9fff9fff9fff9fff9fff9fff9fff9fff9fff9fff9fff9fff9fff9fff9fff9fff9fff9fff9fff9fff9fff9fff9fff9fff9fff9
fff9fff9fff9fff9fff9fff9fff9fff9fff9fff9fff9fff9fff9fff9fff9fff9fff9fff9fff9fff9fff9fff9fff9fff9fff9fff9fff9fff9fff9fff9fff9fff9fff9fff9fff9fff9fff9fff9fff9fff9fff9fff9fff9fff9fff9fff9fff9fff9fff9fff9fff9fff9fff9fff9fff9fff9fff9fff9fff9fff9fff9fff9fff9fff9fff9fff9fff9fff9fff9fff9fff9fff9fff9fff9fff9fff9fff9fff9fff9
fff9fff9fff9fff9fff9fff9fff9fff9fff9fff9fff9fff9fff9fff9fff9fff9fff9fff9fff9fff9fff9fff9fff9fff9fff9fff9fff9fff9fff9fff9fff9fff9fff9fff9fff9fff9fff9fff9fff9fff9fff9fff9fff9fff9fff9fff9fff9fff9fff9fff9fff9fff9fff9fff9fff9fff9fff9fff9fff9fff9fff9fff9fff9fff9fff9fff9fff9fff9fff9fff9fff9fff9fff9fff9fff9fff9fff9fff9fff9
fff9fff9fff9fff9fff9fff9fff9fff9fff9fff9fff9fff9fff9fff9fff9fff9fff9fff9fff9fff9fff9fff9fff9fff9fff9fff9fff9fff9fff9fff9fff9fff9fff9fff9fff9fff9fff9fff9fff9fff9fff9fff9fff9fff9fff9fff9fff9fff9fff9fff9fff9fff9fff9fff9fff9fff9fff9fff9fff9fff9fff9fff9fff9fff9fff9fff9fff9fff9fff9fff9fff9fff9fff9fff9fff9fff9fff9fff9fff9
fff2fff2fff2fff2fff2fff2fff2fff2fff2fff2fff2fff2fff2fff2fff2fff2fff2fff2fff2fff2fff2fff2fff2fff2fff2fff2fff2fff2fff2fff2fff2fff2fff2fff2fff2fff2fff2fff2fff2fff2fff2fff2fff2fff2fff2fff2fff2fff2fff2fff2fff2fff2fff2fff2fff2fff2fff2fff2fff2fff2fff2fff2fff2fff2fff2fff2fff2fff2fff2fff2fff2fff2fff2fff2fff2fff2fff2fff2fff2
fff2fff2fff2fff2fff2fff2fff2fff2fff2fff2fff2fff2fff2fff2fff2fff2fff2fff2fff2fff2fff2fff2fff2fff2fff2fff2fff2fff2fff2fff2fff2fff2fff2fff2fff2fff2fff2fff2fff2fff2fff2fff2fff2fff2fff2fff2fff2fff2fff2fff2fff2fff2fff2fff2fff2fff2fff2fff2fff2fff2fff2fff2fff2fff2fff2fff2fff2fff2fff2fff2fff2fff2fff2fff2fff2fff2fff2fff2fff2
fff2fff2fff2fff2fff2fff2fff2fff2fff2fff2fff2fff2fff2fff2fff2fff2fff2fff2fff2fff2fff2fff2fff2fff2fff2fff2fff2fff2fff2fff2fff2fff2fff2fff2fff2fff2fff2fff2fff2fff2fff2fff2fff2fff2fff2fff2fff2fff2fff2fff2fff2fff2fff2fff2fff2fff2fff2fff2fff2fff2fff2fff2fff2fff2fff2fff2fff2fff2fff2fff2fff2fff2fff2fff2fff2fff2fff2fff2fff2
fff2fff2fff2fff2fff2fff2fff2fff2fff2fff2fff2fff2fff2fff2fff2fff2fff2fff2fff2fff2fff2fff2fff2fff2fff2fff2fff2fff2fff2fff2fff2fff2fff2fff2fff2fff2fff2fff2fff2fff2fff2fff2fff2fff2fff2fff2fff2fff2fff2fff2fff2fff2fff2fff2fff2fff2fff2fff2fff2fff2fff2fff2fff2fff2fff2fff2fff2fff2fff2fff2fff2fff2fff2fff2fff2fff2fff2fff2fff2
fff2fff2fff2fff2fff2fff2fff2fff2fff2fff2fff2fff2fff2fff2fff2fff2fff2fff2fff2fff2fff2fff2fff2fff2fff2fff2fff2fff2fff2fff2fff2fff2fff2fff2fff2fff2fff2fff2fff2fff2fff2fff2fff2fff2fff2fff2fff2fff2fff2fff2fff2fff2fff2fff2fff2fff2fff2fff2fff2fff2fff2fff2fff2fff2fff2fff2fff2fff2fff2fff2fff2fff2fff2fff2fff2fff2fff2fff2fff2
